Стиральная машина indesit wiun102 (33 см) Продается стиральная машина INDESIT wiun102 в отличном состоянии, чистая, никакой ржавчины, есть возможность проверки, отлично стирает отжимает (до 4кг), работает безупречно, имеет компактные размеры (глубина 33см), отжим 1000 оборотов./
/
Общие характеристики/
11 программ стирки/
Максимальная загрузка		4 кг/
Тип загрузки	фронтальная	/
Диаметр люка	30 см/
Макс. скорость отжима	1000 об/мин/
Класс энергоэффективности	A	/
Энергопотребление за цикл	0.95 кВтч/
Класс стирки	A	/
Класс отжима	C	/
Расход воды за цикл	44 л/
Уровень шума при стирке	59 дБ/
Уровень шума при отжиме	79 дБ/
Тип управления	электронный	/
Индикация этапов программы	Да/
Минипрограмма		30 мин/
Режим "цветные ткани"	Да/
Дополнительное полоскание	Да/
Потребляемая мощность	1850 Вт/
Защита от протечек		доп. опция/
Возможность встраивания	Да/
Цвет	белый/
Вес	52.5 кг/
Габаритные размеры/
Высота	85 см/
Ширина	60 см/
Глубина	33 см