Надежный мфу Xerox 3550 Принтер Сканер Копир Тип устройства	МФУ/
Тип	лазерный/светодиодный/
Технология печати	лазерная/
Печать фотографий	Нет/
Копир	Есть/
Сканер	Есть/
Факс	Есть/
Телефон	Нет/
Область применения	средний офис/
Размещение	настольный/
Цветность печати	черно-белая/
Макс. формат	A4/
Число страниц в месяц	75 000/
ПРИНТЕР/
Двусторонняя печать	Есть/
Пигментные чернила	Нет/
МАКС. РАЗРЕШЕНИЕ ДЛЯ Ч/Б ПЕЧАТИ/
По Y	1 200/
По X	1 200/
СКОРОСТЬ Ч/Б ПЕЧАТИ/
A4	33 стр/мин/
ВРЕМЯ ВЫХОДА ПЕРВОГО ОТПЕЧАТКА/
Ч/б	8.5 с/
Печать без полей	Нет/
Прямая печать	Есть/
КОПИР/
Время выхода первой копии	10 с/
МАКС. РАЗРЕШЕНИЕ (Ч/Б)/
По Y	1 200 dpi/
По X	1 200 dpi/
СКОРОСТЬ Ч/Б КОПИРОВАНИЯ/
A4	33 стр/мин/
СКАНЕР/
Тип сканера	планшетный/протяжный/
Макс. формат оригинала	A4/
РАЗРЕШЕНИЕ СКАНЕРА/
По Х (улучшенное)	4 800 dpi/
По Y	4 800 dpi/
Отправка изображения по e-mail	Есть/
РАСХОДНЫЕ МАТЕРИАЛЫ/
Минимальная	60 г/м2/
Максимальная	163 г/м2/
ПЕЧАТЬ НА:/
Карточках	Есть/
Рулоне	Нет/
CD/DVD	Нет/
Глянцевой бумаге	Есть/
Количество картриджей	1/
Матовой бумаге	Есть/
Этикетках	Есть/
Конвертах	Есть/
Пленках	Есть/
ФАКС/
Макс. скорость передачи данных	33.6 Кбит/с/
PC Fax	Есть/
Цветной	Есть/
ТЕЛЕФОН/
Caller ID	Нет/
Автоответчик	Нет/
АОН	Нет/
Беспроводная трубка	Нет/
Спикерфон	Нет/
Стандарт DECT	Нет/
Проводная трубка	Нет/
ШРИФТЫ И ЯЗЫКИ УПРАВЛЕНИЯ/
PostScript	Есть/
PPDS	Нет/
PCL 5e	Есть/
PostScript 2	Нет/
PostScript 3	Есть/
PCL 6	Есть/
PCL 5c	Нет/
ЛОТКИ/
Емкость лотка ручной подачи	50 листов/
ПОДАЧА БУМАГИ/
Стандартная	550 листов/
Максимальная	1 050 листов/
ВЫВОД БУМАГИ/
Стандартный	250 листов/
ФИНИШЕР/
Брошюровщик	Нет/
Степлер	Нет/
Сортер	Нет/
ИНТЕРФЕЙСЫ/
Устройство для чтения карт памяти	Нет/
Wi-Fi	Нет/
RS-232	Нет/
FireWire (IEEE 1394)	Нет/
Версия USB	2.0/
LPT	Нет/
USB	Есть/
Ethernet (RJ-45)	Есть/
Bluetooth	Нет/
Инфракрасный порт	Нет/
ПАМЯТЬ/ПРОЦЕССОР/
Объем памяти	256 Мб/
Макс. объем памяти	512 Мб/
Частота процессора	360 МГц/
ДОПОЛНИТЕЛЬНАЯ ИНФОРМАЦИЯ/
Экран	ЖК-панель/
Работа от аккумулятора	Нет/
ПОДДЕРЖКА ОС/
Mac OS	Есть/
Windows	Есть/
ПОТРЕБЛЯЕМАЯ МОЩНОСТЬ/
При работе	600 Вт/
В режиме ожидания	20 Вт/
УРОВЕНЬ ШУМА/
При работе	55 дБ/
В режиме ожидания	39 дБ/
ГАБАРИТЫ/
Глубина	488 мм/
Ширина	582 мм/
Высота	554 мм/
Вес	23.4 кг