Мфу HP LaserJet Pro M125rnw Продаю МФУ HP LaserJet Pro M125rnw  (практически не использовался) в идеальном состоянии, с WI-FI, можно распечатывать файлы со смартфона!!! /
/
Основные характеристики/
Технология печати	лазерный/
Тип печати	черно-белый/
Формат печати	A4/
Размещение	настольный/
Встроенный ЖК-дисплей	монохромный/
Сканер	есть/
Копировальный аппарат	есть/
Печать/
Максимальная скорость ЧБ-печати (А4)	20 стр/мин/
Время печати первой страницы А4 (ч/б)	9.5 с/
Максимальное разрешение ч/б печати	600×600 dpi/
Печать на карточках	есть/
Печать на пленке	есть/
Печать на конвертах	есть/
Нагрузка (А4, в месяц)	8000/
Сканер/
Тип сканирующего устройства	планшетный/
Максимальный формат сканирования	A4/
Скорость сканирования (ч/б)	7 стр/мин/
Скорость сканирования (цвет)	7 стр/мин/
Разрешение сканирования	1200×1200 dpi/
Максимальный размер сканирования	216×297 мм/
Копир/
Максимальный формат копирования	A4/
Скорость копирования (А4)	20 стр/мин/
Максимальное разрешение ч/б копирования	300×300 dpi/
Максимальное количество копий за цикл	99 шт/
Масштабирование	25-400%/
Расходные материалы/
Минимальная плотность бумаги	60 г/м2/
Максимальная плотность бумаги	163 г/м2/
Количество картриджей	1/
Лотки/
Подача бумаги (стандарт)	150/
Выход бумаги (стандарт)	100/
Процессор, память/
Частота процессора	600 МГц/
Объем оперативной памяти (стандартный)	128 Мб/
Максимальный объем оперативной памяти, до	128 Мб/
Шрифты и языки управления/
Поддержка языков управления	PCLm/PCLmS/
Разъемы, интерфейсы/
Интерфейс USB 2.0	есть/
Интерфейс RJ-45	есть/
Беспроводной интерфейс WiFi	есть/
Поддержка Air Print	есть/
Особенности/
Особенности	поддержка многозадачности, HP ePrint/
Энергопотребление/
Потребляемая мощность при работе	465 Вт/
Потребляемая мощность в режиме ожидания	2.2 Вт/
Цвет и габариты/
Цвет	черный/
Размеры	420×254×365 мм/
Вес	8 кг