Книги ЦЕЛЫЙ ПАКЕТ ДЕТЕКТИВОВ ЗА ОДНУ ШОКОЛАДКУ!!!/
Название книги автор жанр /
высокий блондин на белой лошади  андреева	детектив/
новое платье королевы АНДРЕЕВА	детектив/
эта горькая сладкая месть ДОНЦОВА	детектив/
наваждение ДУБРОВИНА	детектив/
рязащий удар КОРЕЦКИЙ	детектив/
берег удачи КРИСТИ	детектив/
в 4 50 из паддингтона КРИСТИ	детектив/
вилла белый конь КРИСТИ	детектив/
вуду для чайников КУЛИКОВА	детектив/
предмет вожделения ЛИТВИНОВЫ	детектив/
белоснежка и семь трупов луганцева	детектив/
запчасти для невесты луганцева	детектив/
курьер счастья или повелительница сердец луганцева	детектив/
страх перед страхом МАЛЫШЕВА	детектив/
реквием МАРИНИНА	детектив/
черное дно МОРОЗОВ	детектив/
вкус ледяного поцелуя полякова	детектив/
леди феникс  полякова	детектив/
чудо в пушистых перьях полякова	детектив/
бес в ребро СЕРОВА	детектив/
ловушка для профессионала СМИРНОВ	детектив/
дои фантом в приданное устинова	детектив/
закон обратного волшебства устинова	детектив/
миф об идеальном мужчине устинова	детектив/
один день одна ночь устинова	детектив/
отель последней надежды  устинова	детектив/
первое правило королевы устинова	детектив/
курортный роман или звезда сомнительного счастья ШИЛОВА	детектив/
ублюдки ХЭММЕТ	детектив/
преграды любви ГРИФИТС	детектив/
большей любви не бывает СТИЛ	детектив/
кольцо СТИЛ	детектив/
светоч любви ХОЛТ	детектив/
секретные материалы 4 книги 	детектив/
КЕНГУРУ В ПИДЖАКЕ ГОНЧАРОВА	детектив/
золотой теленок, 12 стульев Ильф и Петров	классика/
сборник Чехов 3 том	классика/
Обыкновенная история Гончаров	классика/
РОБИНЗОН КРУЗО	классика/
РАССКАЗЫ О ЖИВОТНЫХ ЛОНДОН СЕТОН-ТОМПСОН ЗАЛЬТЕН	классика/
ГРАММАТИКА ЛЮБВИ БУНИН	классика/
РАССКАЗЫ О ЖИВОТНЫХ СБОРНИК	классика/
МОЯ ЖИЗНЬ СЕТОН-ТОМПСОН	классика/
ОШО ТАНТРА 1,2,5 ТОМ	спец/
ВСЕ О МАССАЖЕ ВАСИЧКИН	спец/
ВАШИ ДОМАШНИЕ ЧЕТВЕРОНОГИЕ ДРУЗЬЯ	спец/
ЭНЦИКЛОПЕДИЯ ДЛЯ МАЛЕНЬКИХ ПРИНЦЕСС	спец/
СТОЛЯРНОЕ ДЕЛО	спец/
история европы Чубарьян (8 томник) -2,3,4 тома	спец/
история внешней дипломатии Потемкин 1,2 том	спец/
справочник по математике Корн -1,2 том	спец/
ПУТЬ В ЙОГУ ТИАНАНДА	спец/
ЭТА ЗАМЕЧАТЕЛЬНАЯ ЙОГА	спец/
КУЛИНАРИЯ ВО ДНИ ПОСТА	спец/
АТЛАС МИРА МАЛЫЙ	спец/
МИР ИСТОРИИ РЫБАКОВ	спец/
ЗАЛОГ ВОЗМОЖНОСТИ СУЩЕСТВОВАНИЯ ПОКРАСС	спец/
ЛЕКАРСТВЕННЫЕ РАСТЕНИЯ СРЕДНЕГО ПОВОЛЖЬЯ	спец/
НА СУШЕ НА МОРЕ 1977 	спец/
НА СУШЕ НА МОРЕ 1978	спец/
ДЕТСКАЯ БИБЛИЯ	спец/
ПЧЕЛОВОДСТВО	спец/
БИБЛИЯ	спец/
ТЕРАПИЯ ПОВЕДЕНИЕМ ПОКРАСС	спец/
КУЛИНАРИЯ ОБРАЗЦОВАЯ КУХНЯ	спец/
ПЧЕЛИНАЯ АПТЕКА	спец/
ДОМАШНЕЕ КОНСЕРВИРОВАНИЕ	спец/
РАСТЕНИЯ ЦЕЛИТЕЛИ	спец/
ПОМОЩЬ СТРАЖДУЩЕЙ ДУШЕ ОПЫТ ВРАЧЕБНОГО ДУШЕПОПЕЧЕНИЯ	спец/
МОЛОЧНАЯ КУЛИНАРИЯ	спец/
БЛЮДА ИЗ ГРИБОВ И КАРТОФЕЛЯ	спец/
РУССКОЕ РАЗНОТРАВЬЕ НАРОДНАЯ МЕДИЦИНА	спец/
ЙОГА ПОЛНАЯ ЭНЦИКЛОПЕДИЯ	спец/
странствия кукши за тридевять земель Вронский	фантастика/
мистер мерседес стивен кинг	фантастика КУПИЛИ/
юлианна или опасные игры вознесенская	фантастика/
ИДЕАЛЬНОЕ ПРЕСТУПЛЕНИЕ БОЙС	фантастика/
ЧАРОДЕЙ ПО НЕВОЛЕ ВОЗВРАЩЕНИЕ КОРОЛЯ КОБОЛДА СТАШЕФФ	фантастика/
ХЛЕБ ВЕЛИКАНОВ -ДЕТСКАЯ