15.6" Ноутбук DNS 0801232 серый Внешний вид/
Цвет верхней крышки	серый/
Экран/
Тип экрана	TN+film/
Диагональ экрана	15.6"/
Разрешение экрана	1366x768/
Покрытие экрана	глянцевое/
Процессор/
Производитель процессора	AMD/
Линейка процессора	AMD A4/
Количество ядер процессора	4/
Частота	1.5 ГГц/
Автоматическое увеличение частоты	нет/
Оперативная память/
Размер оперативной памяти	2 Гб/
Графический ускоритель/
Вид графического ускорителя	встроенный/
Производитель видеочипа	AMD/
Модель дискретной видеокарты	нет/
Модель встроенной видеокарты	Radeon HD 8330/
Накопители данных/
Общий объём жестких дисков (HDD)	500 Гб/
Общий объем твердотельных накопителей (SSD)	нет/
Питание/
Емкость аккумулятора	4400 мАч/
Габариты, вес/
Вес	1.9 кг