Фотоаппарат Sony Alpha SLT-A57 №1/S Фотоаппарат Sony Alpha SLT-A57 в отличном состоянии!/
Объектив в комплекте	Да/
Подсветка автофокуса	Да/
Фокусировка по лицу	Да/
Ручная фокусировка	Да/
Возможность смены объектива	байонет Sony A/
МАТРИЦА/
Число эффективных мегапикселей матрицы	16.1 млн/
Функция очистки матрицы	Да/
Кроп-фактор	1.5/
Физический размер матрицы	APS-C (23.5 x 15.6 мм)/
Тип матрицы	CMOS/
Число мегапикселей матрицы	16.7 млн/
Максимальное разрешение	4912 x 3264/
Чувствительность	100 - 3200 ISO, Auto ISO/
Расширенные значения ISO	ISO6400, ISO12800, ISO25600/
ВИДОИСКАТЕЛЬ И ЭКРАН/
Число пикселов видоискателя	1440000/
Поле зрения видоискателя	100%/
LCD-экран	921600 точек, 3 дюйма/
Использование экрана в качестве видоискателя	Да/
Тип видоискателя	электронный/
Тип ЖК-экрана	поворотный/
ВЫДЕРЖКА/
Ручные настройки выдержки и диафрагмы	Да/
УПРАВЛЕНИЕ СВЕТОМ/
Экспокоррекция	+/- 3 EV с шагом 1/3 ступени/
Брекетинг	Да/
Автоматическая обработка экспозиции	с приоритетом затвора, с приоритетом диафрагмы/
Замер экспозиции	мультизонный, центровзвешенный, точечный/
БАЛАНС БЕЛОГО/
Баланс белого	автоматический, ручная установка, из списка, брекетинг/
ВСПЫШКА/
Вспышка	встроенная, до 10 м, подавление эффекта красных глаз, башмак/
СТАБИЛИЗАЦИЯ/
Стабилизатор изображения (фотосъемка)	оптический, сдвиг матрицы/
ВИДЕО- И ЗВУКОЗАПИСЬ/
Макс. частота кадров видеоролика	60 кадров/с/
Макс. разрешение видеозаписи	1920x1080/
Запись видео	Да/
Запись звука	Да/
Максимальная частота кадров при съемке HD-видео	50/60 кадров/с при разрешении 1920x1080/
Видеокодеки	AVC/H.264, MPEG4/
Формат записи видео	AVCHD, MP4/
ИНТЕРФЕЙСЫ И ПАМЯТЬ/
Тип карт памяти	SD, SDHC, SDXC, Memory Stick Pro Duo, Memory Stick PRO-HG Duo/
Форматы изображения	JPEG (2 уровня сжат.), RAW/
Интерфейсы	USB 2.0, видео, HD-видео, HDMI, аудио, IRDA, разъем для пульта ДУ/
СКОРОСТЬ И РЕЖИМЫ СЪЕМКИ/
Таймер	Да/
Скорость съемки	12 кадр./сек/
Формат кадра (фотосъемка)	3:2, 16:9/
ПИТАНИЕ/
Разъем питания	Да/
Емкость аккумулятора	550 фотографий/
Количество аккумуляторов	1/
Тип аккумуляторов	свой собственный/
ГАБАРИТЫ/
Вес (без элементов питания)	539 г, без элементов питания; 618 г, с элементами питания, без объектива/
Размер	132x98x81 мм, без объектива/
ДОПОЛНИТЕЛЬНАЯ ИНФОРМАЦИЯ/
Тип камеры	зеркальная/
Дополнительная информация	режим панорамы/
Дата начала продаж	2012-04-15/
Дополнительные возможности	крепление для штатива, дистанционное управление, датчик ориентации, cъемка HDR/
Возможен обмен на электроинструмент, бытовую технику или мобильный телефон./
Находимся по адресу: г.Москва, ул.Окская, д. 28, корпус 3. Ближайшее метро Кузьминки, Рязанский проспект.  Режим работы: без выходных и праздников с 10.00 до 21.00  Перед приездом ОБЯЗАТЕЛЬНО уточняйте наличиe товара./
Доставка по России осуществляется транспортными компаниями ПЭК, Деловые линии, СДЭК, ЖелДорЭкспедиция, только после 100% оплаты (форма оплаты любая). Доставка до ТК бесплатная. Работаем без НДС.