Моноблок SKY systems MB-J175450V020 Процессор	Intel Celeron/
Количество ядер	2/
Модель процессора	J1750/
Тактовая частота	2 410 МГц/
Turbo-частота	нет/
Кэш (общий, L2 или L3)	1 МБ/
Энергопотребление процессора (TDP)	7.5 Вт/
Графика/
Тип графического адаптера	встроенный/
Графический адаптер	Intel HD Graphics/
Интерфейсы/
Wi-Fi	Есть/
LAN	1 Gbit/
Камера и звук/
Встроенная камера	1/
Встроенный микрофон	Есть/
Комплектация/
Клавиатура	Есть/
Операционная система	Windows 8.1/
Мышь	Есть/
Конструкция/
Цвет корпуса	черный/
Подсветка корпуса	Нет/
Оперативная память/
Тип оперативной памяти	DDR3/
Объем памяти	2 ГБ/
Функциональность/
Пульт ДУ	Нет/
TV-тюнер	Нет/
Хранение данных/
Тип жесткого диска (дисков)	HDD/
Емкость жесткого диска	500 Гб/
Скорость вращения	5400 RPM/
Щелевая загрузка дисков	Нет/
Карты памяти	Есть/
Экран/
Диагональ экрана	19.5"/
Технология экрана	TN+Film/
Разрешение экрана	1600 x 900/
Сенсорный экран	Нет