Монитор SAMSUNG SyncMaster 797MB Тип	ЭЛТ монитор/
Дисплей	 /
Технология	ЭЛТ/
Название кинескопа	DynaFlat/
Диагональ	17"/
Размер диагонали видимой области	16"/
Размер видимой области по горизонтали	325 мм/
Размер видимой области по вертикали	244 мм/
Разрешение (макс.)	1920 x 1440/
Частота верт. развертки (макс. разр.)	64 Гц/
Размер зерна	0.2 мм/
Рекомендуемое разрешение и частота	1280 x 1024 @ 85 Гц/
Частота гориз. развертки (мин.)	30 кГц/
Частота гориз. развертки (макс.)	96 кГц/
Частота верт. развертки (мин.)	50 Гц/
Частота верт. развертки (макс.)	160 Гц/
Полоса пропускания	250 МГц/
Тип покрытия экрана	многослойное/
Настройки дисплея	блокировка управления, выбор языка меню, размагничивание, контрастность, параллелограм, наклон, масштаб, поворот, положение по горизонтали и вертикали, сброс установленных параметров, трапеция, устранение муара, яркость/
Интерфейсы	 /
Интерфейсы / коннекторы	VGA - HD D-Sub 15/
Питание	 /
Входное напряжение	90 - 264 В/
Потребляемая мощность (рабочая)	80 Вт/
Поддерживаемые стандарты	 /
Cтандарты безопасности	TCO '03/
Стандарты и сертификаты	C-TICK, CE, CSA, DDC-2B, DDC-2Bi, EPA Energy Star, FCC Class B, GOST, NEMKO, TUV, UL, VCCI/
Габариты / вес	 /
Габариты с подставкой (ширина х высота х длина)	40.1 x 37.8 x 41 см/
Вес (с подставкой)	14.3 кг